076666667666666292
066666666666667050
000000000000000010
031111111111111110
000000001000000000
066666601066666660
066666601066766660
066676601066666760
222222231222222222
000000001000000000
011111111111111140
080000000000000000