222222222222222222
200000000000000002
201111111111111158
201430000000000002
221222222222222222
205000000000000002
201111111111111102
200000000000034102
222222222222222522
000000000000000100
011111111111111100
094300000000000000