292222222222222222
252066766666660000
010066666676660406
010066666666660106
010000000000000106
011111111111111107
000000000000000106
066766666666760106
066666676666660100
222222222222222522
001111111111111113
008000000000000000